1111111111111111111111111
1000000000000000000000001
1000000000000000000000001
1000111111100011111110001
1000000000000000000000001
1000000000000000000000001
1000001111111111111000001
1000000000000000000000001
1000000000000000000000001
1001001000000000001001001
1001001111100011111001001
1001000000000000000001001
1001000000000000000001001
1001000000000000000001001
1001001111100011111001001
1001001000000000001001001
1000000000000000000000001
1000000000000000000000001
1000001111111111111000001
1000000000000000000000001
1000000000000000000000001
1000111111100011111110001
1000000000000000000000001
1000000000000000000000001
1111111111111111111111111
