25x25
1111111111111111111111111
1000000001100000000000001
1000000001100000000000001
1000000001100000000000001
1000000001100001100000001
1000000001100001100000001
1000000001100001100000001
1000000001100001100000001
1000111111100001100000001
1000111111100001111111111
1000000000000001111111111
1000000000000000000000001
1000000000000000000000001
1000000000000000000000001
1111111111000000000000001
1111111111000011111110001
1000000011000011111110001
1000000011000011000000001
1000000011000011000000001
1000000011000011000000001
1000000011000011000000001
1000000000000011000000001
1000000000000011000000001
1000000000000011000000001
1111111111111111111111111
