25x25
1111111111111111111111111
1000111000000000001110001
1000111000000000001110001
1000111000000000001110001
1000000000001000000000001
1000000001111111000000001
1000000000001000000000001
1000000000000000000000001
1000001100011111111000001
1001001100011111111001001
1011101100000000011011101
1001001100011100011001001
1001001100010100011001001
1011101100011100011011101
1001001100000000011001001
1000001111111100011000001
1000001111111100011000001
1000000000000000000000001
1000000000001000000000001
1000000001111111000000001
1000000000001000000000001
1000111000000000001110001
1000111000000000001110001
1000111000000000001110001
1111111111111111111111111
