25x25
1111111111111111111111111
1000000000000000000000001
1000001000000000001000001
1000001000011100001000001
1000111110000100111110001
1000000000011100000000001
1000000000010000000000001
1111000000011100000001111
0001000000000000000001000
0001000000111100000001000
0001000000000000000001000
0001000010000001000001000
0001000010000001000001000
0001000010000001000001000
0001000000000000000001000
0001000000111100000001000
0001000000000000000001000
1111000000011100000001111
1000000000000100000000001
1000000000011100000000001
1000111110010000111110001
1000001000011100001000001
1000001000000000001000001
1000000000000000000000001
1111111111111111111111111
