25x25
1111111111111111111111111
1000000001100111000000001
1000000001100000000000001
1001110001100000000111001
1001110001100001100111001
1001110001100001100111001
1000000001100001100000001
1000000001100001100000001
1000111111100001100000001
1100111111100001111111111
1100000000000001111111111
1100111100001000000000001
1000111100011100111100001
1000000000001000111100011
1111111111000000000000011
1111111111000011111110011
1000000011000011111110001
1000000011000011000000001
1000000011000011000000001
1001110011000011000111001
1001110011000011000111001
1001110000000011000111001
1000000000000011000000001
1000000001110011000000001
1111111111111111111111111
