25x25
1111111111111111111111111
1100000000000000000000011
1000000000000000000000001
1000111111100011111110001
1000110000000000000110001
1000100000000000000010001
1000001111111111111000001
1000001001100011001000001
1000001001100011001000001
1001001000000000001001001
1001001111100011111001001
1001000000000000000001001
1001100000000000000011001
1001000000000000000001001
1001001111100011111001001
1001001000000000001001001
1000001001100011001000001
1000001001100011001000001
1000001111111111111000001
1000100000000000000010001
1000110000000000000110001
1000111111100011111110001
1000000000000000000000001
1100000000000000000000011
1111111111111111111111111
