25x25
1111111111111111111111111
1000000000000000000000001
1000001000000000001000001
1000001000011100001000001
1000111110000100111110001
1000001000011100001000001
1000000000000100000000001
1111000000011100000001111
0001000000000000000001000
0001100000111100000011000
0001000000000000000001000
0001000010011001000001000
0001100010111101000011000
0001000010000001000001000
0001000010000001000001000
0001100011111111000011000
0001000000000000000001000
1111000000011100000001111
1000000000000100000000001
1000001000011100001000001
1000111110000100111110001
1000001000011100001000001
1000001000000000001000001
1000000000000000000000001
1111111111111111111111111
