25x25
1111111111111111111111111
1200000001100400000000001
1000000001100400000000001
1001110001100400000111001
1001110001100001100111001
1001110001100001100111001
1000000001100001100000001
1000000001100001100000001
1000111111100001100000001
1000111111100001111111111
1000000000000001111111111
1444011110001000000000001
1000011110011100111100001
1000000000001000111104441
1111111111000000000000031
1111111111000011111110001
1000000011000011111110001
1000000011000011000000001
1000000011000011000000001
1001110011000011000111001
1001110011000011000111001
1001110000040011000111001
1000000000040011000000001
1000000000040011000000001
1111111111111111111111111
