25x25
1111111111111111111111111
1044000000000000000004401
1044001000000000001004401
1000001000010100001000001
1000111110010100111110001
1000001000011100001000001
1000000000000100000000001
1111000044000144000001111
0001000044000044000001000
0001100044111144000011000
0001000000000000000001000
0001000010011001000001000
0001100010111101000011000
0001000010000001000001000
0001000010000001000001000
0001100011111111000011000
0001000000000000000001000
1111000000010100000001111
1000000000010100000000001
1000001000011100001000001
1000111110000100111110001
1000001000000100001000001
1044001000000000001004401
1044000000000000000004401
1111111111111111111111111
