25x25
1111111111111111111111111
1000000000000000000000001
1000000044400044400000001
1000111111100011111110001
1000000000000000000000001
1004400000000000000044001
1004401111111111111044001
1000001000000000001000001
1000001000000000001000001
1001001000000000001001001
1001001111100011111001001
1001000000000000000001001
1001000000044400000001001
1001000000000000000001001
1001001111100011111001001
1001001000000000001001001
1000001000000000001000001
1000001000000000001000001
1004401111111111111044001
1004400000000000000044001
1000000000000000000000001
1000111111100011111110001
1000000044400044400000001
1000000000000000000000001
1111111111111111111111111
