25x25
1111111111111111111111111
1000111000000000001110001
1011111110000000111111101
1000111000001000001110001
1000000000001000000000001
1000044001111111004400001
1000044000000000004400001
1000000000000000000000001
1000001104411111111000001
1001001104411111111001001
1011101100000000011011101
1001001100011100011001001
1001001100010100011001001
1011101100011100011011101
1001001100000000011001001
1000001111111144011000001
1000001111111144011000001
1000000000000000000000001
1000044000000000004400001
1000044001111111004400001
1000000000001000000000001
1000111000001000001110001
1000111000000000001110001
1000111000000000001110001
1111111111111111111111111
